EEEEEEEEEEEE
EWWWEEWWEEWE
EEWEWEWEEEWA
EEWEEWWEEEWE
EEEEEEWEEEWE
EEWWWWWWEEWE
EEEEEEEWEEWE
EWWEWEWEEWWE
EEWDWEWEEEWE
EEWWWEEEEEWE
EEEEEWEEEEWE
WWWWWWWWEEEE
