EEEEEEEEEE
EEEEEEEEEE
EEEEWEEEEE
EEEEWWAEEE
EEEEEDWEEE
EEEEEEWEEE
EEEEEEEEEE
EEEEEEEEEE
EEEEEEEEEE
EEEEEEEEEE
