EWWEAEEEEE
EEWEEEEEEE
EEWEWWWWDE
EEEEEEWEEE
EEWWWWWEEE
EEEEEEEEEE
EEWEWEEEEE
EEWEWEEEEE
EEWWWEEEEE
EEEEEEEEEE