EEEEEEEEEE
EEEEEEEEEE
EEEEEEEEEE
EEEWWWEEEE
EEEEWEEEEE
EEEEWEEEEE
EWEEWDEEEE
EWAWWWEEEE
EWWWEEEEEE
EEEEEEEEEE
