EEEEEEEEEEW
EWWWEEWWEEW
EEWEWEWEEEW
EEWEEWWEEEW
EEEEEEWAEEW
EEWWWWWWEEW
EEEEEEEWEEW
EWWEWEWEEWW
EEWDWEWEEEW
EEWWWEEEEEW
EEEEEWEEEEW
